     NO	 									./textures/alga.png 
F 251, 208, 177

WE ./textures/peces.png

SO ./textures/alga.png   

EA ./textures/bob_esponja.png
							C	 0, 46, 61

1111111111111
1000001000001
1000000000001
1000000000001
10010000000001
1000010100001
1000100010001111
1100000000001101
10001000100010111
10N001010000011
10000000000001
1111111111111
100001010000011
10000000000001
1111111111111
