NO ./textures/my_sea.png
SO ./textures/my_sea.png  
WE ./textures/last_chance.png
EA ./textures/last_chance.png
F 244, 192, 149 
C 225,30,0

        1111111111111111111111111
111111111111111111111111111111111
1111011111   10111000000100011111
111101111111110111010100100011111
11000000110101011100000010001
1000100E0000000001100000010101
1001 100000000000001010010001
10001000000000001101010010001
10000011101010111110111100001
11110111 1110101 101111010001
11111111 1111111 111111111111
