NO ./textures/TILE_1A.png 

SO ./textures/TILE_2C.png 
EA ./textures/weird_rock.png 
WE ./textures/SLUDGE_1A.png 



C 2, 1, 1

F 2, 1, 1

        1111111111111111111111111
        1000000000110000000000001     1111111
        1011000001110000000000001     1000001
        1001000000000000000000001     1111111
111111111011000001110000000000001
100000000011000001110111111111111
11110111111111011100000010001
11110111111111011101010000001
11000000110101011100000010001
10000000000000001100000000001
10000000000000001101010010N01
11000001110101011111011110001
11110111 1110101 101111010001
11111111 1111111 111111111111
