	 NO										./textures/alga.png 
F 251, 208, 177

WE ./textures/peces.png

SO ./textures/alga.png	



EA ./textures/bob_esponja.png
													C	 173, 235, 255

111111111111
1000001000001
11111111111111111111
1001 100000000011111111
11111111000000000001
10N00000000001111111
1000000000001  1111
100001010001  1111
1000100010001
1000010100001
1001000000001
111 1111111111
