11111111      1111
110101 111   100N01
11111111      11111
